###########################
#.......G...##..........P.#
#..........##.............#
#..............W..........#
#..........##.............#
#.....................W...#
#..........##.............#
#..........##...Z...W.....#
#..........##.............#
#K.........##.........G...#
###########################