#.......G..##.........P#
#..........##..........#
#..........##..........#
#......................#
#..........##..........#
#......................#
#..........##..........#
#..........##...Z......#
#..........##..........#
#..........##..........#
#K.........##..........#