#P.......#
#........#
#........#
#........#
#........#
#........#
#........#
#.....Z..#
#........#
#HZ......#