#..Z......P#
#..........#
#Z.........#
#..Z.......#
#..........#
#Z.......Z.#
#..........#
#..........#
#Z.........#
#..Z.......#
#..........#
#H.........#