###########################
#.......G...##..........P.#
#..........##.............#
#..............W..........#
#..........##.............#
#.....................W...#
#..........##.............#
#..........##...Z.........#
#..........##.............#
#K.........##.............#
###########################