#.........P#
#..........#
#..........#
#..........#
#..........#
#..........#
#..........#
#..........#
#..........#
#..........#
#..........#
#HZZ.......#