#P.......#
#........#
#........#
#........#
#........#
#........#
#........#
#.....Z..#
#........#
#H..Z....#