#P..#
#...#
#Z..#
#...#
#H..#
