###########################
#.......G...##..N........P.#
#..........##.............#
#...............Z.........#
#..........##.............#
#...W.....................#
#......Z...##.............#
#..........##.........G...#
#..........##........W....#
#K.........##.............#
###########################