#P.......#
#Z.......#
#........#
#........#
#Z.......#
#........#
#........#
#.....Z..#
#........#
#H.......#