###########################
#.......G...##..N........P.#
#..........##.............#
#....W..........Z.........#
#..........##.............#
#...W............W........#
#......Z...##.............#
#..........##.........G...#
#..........##.........W...#
#K....Z....##.........D...#
###########################