###########################
#...........##..N........P.#
#..........##.......W.....#
#....W..........Z.........#
#..........##.............#
#...W............W........#
#......Z...##.............#
#G.........##.........G...#
#..........##.........W...#
#K.Z..Z....##.........D...#
###########################