############
#.........P#
#..........#
#..KZ.W....#
#..........#
############